60ZEICH.json	60ZEICH
ACADEMY.json	ACADEMY
ADVEN.json	ADVEN
ADVENTUR.json	ADVENTUR
AGASOFT.json	AGASOFT
ANALOG.json	ANALOG
ANTIC.json	ANTIC
ANTIC3.json	ANTIC3
ANTIK2.json	ANTIK2
ARCHAIC 2.json	ARCHAIC 2
AREX.json	AREX
AROGUE.json	AROGUE
ARTDECO.json	ARTDECO
ASCPRIN.json	ASCPRIN
ATPL5.json	ATPL5
BACKTALK 2.json	BACKTALK 2
BALOON.json	BALOON
BARYMAG.json	BARYMAG
BIGONES.json	BIGONES
BIGPL.json	BIGPL
BLMON.json	BLMON
BLOCK 2.json	BLOCK 2
BOLD.json	BOLD
BOLD2.json	BOLD2
BOZO.json	BOZO
BROADWAY.json	BROADWAY
BZZZ1.json	BZZZ1
BZZZ2.json	BZZZ2
BZZZ3.json	BZZZ3
CAPS.json	CAPS
CASUAL.json	CASUAL
CASUALGT.json	CASUALGT
CHAR4.json	CHAR4
CHARLIE.json	CHARLIE
CHEMICAL.json	CHEMICAL
CHOPER1.json	CHOPER1
CHOPER5.json	CHOPER5
CHRIS.json	CHRIS
CHSET2.json	CHSET2
CLASSIC.json	CLASSIC
clmfont1.json	clmfont1
COL64A.json	COL64A
COL64B.json	COL64B
COL80A.json	COL80A
COMP1.json	COMP1
COMP2.json	COMP2
COMPUT1.json	COMPUT1
COPY98K.json	COPY98K
CRAZY.json	CRAZY
CURL.json	CURL
CURSIVE1 2.json	CURSIVE1 2
DATA.json	DATA
DATRI.json	DATRI
DBLROMAN.json	DBLROMAN
DBLTHIN.json	DBLTHIN
DESCEND.json	DESCEND
DIGI.json	DIGI
DINO.json	DINO
DINO 2.json	DINO 2
ECKIG2PL.json	ECKIG2PL
EIGHTY.json	EIGHTY
EL1.json	EL1
EL1W.json	EL1W
EMBLEM.json	EMBLEM
EQUALIZ.json	EQUALIZ
EUROPA.json	EUROPA
F80.json	F80
FANCY1 2.json	FANCY1 2
FANCY2.json	FANCY2
FANCY2B.json	FANCY2B
FANCY3B.json	FANCY3B
FANCY5.json	FANCY5
FAT.json	FAT
FAT64.json	FAT64
FATPL.json	FATPL
FENCEPS.json	FENCEPS
FIG64PL1.json	FIG64PL1
FIVEDEM.json	FIVEDEM
FLATFOOT 2.json	FLATFOOT 2
FLICK80.json	FLICK80
flight.json	flight
FONTS2.json	FONTS2
FONTS3.json	FONTS3
FRACTAL.json	FRACTAL
GLADIATR.json	GLADIATR
GOTHIC.json	GOTHIC
GOTHIC1 2.json	GOTHIC1 2
GOTHIC3.json	GOTHIC3
GOTHIC5.json	GOTHIC5
GOTYK3.json	GOTYK3
GRUBE.json	GRUBE
HAPPY.json	HAPPY
HEHE.json	HEHE
HERO.json	HERO
HOCH.json	HOCH
HOMEPACK.json	HOMEPACK
HOVER.json	HOVER
HSOFT.json	HSOFT
HUBBA.json	HUBBA
HUGO.json	HUGO
HUGO1.json	HUGO1
HUGO3.json	HUGO3
IMP1029.json	IMP1029
INITPRG.json	INITPRG
INTERNAT.json	INTERNAT
ITALIC1.json	ITALIC1
ITALIC3.json	ITALIC3
ITALICPL.json	ITALICPL
JERRY.json	JERRY
KAMPANIA.json	KAMPANIA
KAZ1.json	KAZ1
KAZ2.json	KAZ2
KAZ3.json	KAZ3
KAZ4.json	KAZ4
KAZ5.json	KAZ5
KAZ6.json	KAZ6
KNIFFEL.json	KNIFFEL
KOSCI1.json	KOSCI1
KRYSZTAL.json	KRYSZTAL
LARGE.json	LARGE
LARGE2.json	LARGE2
LATEIN.json	LATEIN
LITERKI.json	LITERKI
MARCO.json	MARCO
MATH.json	MATH
MAX.json	MAX
MEDEVAL.json	MEDEVAL
MENU.json	MENU
METAL.json	METAL
MODERN.json	MODERN
MODERN1.json	MODERN1
MODERNE.json	MODERNE
MOJ.json	MOJ
MYDEMO.json	MYDEMO
NATO.json	NATO
NC1.json	NC1
NC5.json	NC5
NEW.json	NEW
NEWSLETR.json	NEWSLETR
NFL.json	NFL
NICEONE.json	NICEONE
NICETINY.json	NICETINY
NVDI8.json	NVDI8
OBCY.json	OBCY
OBCY2.json	OBCY2
OLD.json	OLD
OLDE.json	OLDE
OLDSTYLE.json	OLDSTYLE
ORTOGRAF.json	ORTOGRAF
OUTLINE.json	OUTLINE
PANTH.json	PANTH
PANTHER.json	PANTHER
PANTHER2.json	PANTHER2
PE1.json	PE1
PEDROKKO.json	PEDROKKO
PERFECT.json	PERFECT
PIPELINE.json	PIPELINE
PREPPIE.json	PREPPIE
PROPORT.json	PROPORT
PUCMUC.json	PUCMUC
QUATRO.json	QUATRO
QUIZ.json	QUIZ
RALLY.json	RALLY
reversi.json	reversi
ROBBOPL.json	ROBBOPL
ROM.json	ROM
ROMAN.json	ROMAN
RSPEED.json	RSPEED
RUSSISCH.json	RUSSISCH
RZBIK.json	RZBIK
SCHREIB 2.json	SCHREIB 2
SCRIPT2.json	SCRIPT2
sdcart.json	sdcart
sdcart2.json	sdcart2
SERIF.json	SERIF
SEXQUIX.json	SEXQUIX
SEXQUIX2.json	SEXQUIX2
SGLSANS.json	SGLSANS
SHATAN.json	SHATAN
SHIT.json	SHIT
SIMPLEX.json	SIMPLEX
SINCLAIR.json	SINCLAIR
SNOKIE.json	SNOKIE
SPACE.json	SPACE
SPDSCRP.json	SPDSCRP
SPECIAL.json	SPECIAL
SQUARE.json	SQUARE
STANDARD.json	STANDARD
STENCIL.json	STENCIL
STOP.json	STOP
STRACK.json	STRACK
STRANGE.json	STRANGE
STRICH.json	STRICH
STYLISH.json	STYLISH
SWORD.json	SWORD
SYSTEM2.json	SYSTEM2
SZPER2.json	SZPER2
TA1.json	TA1
TACCHR.json	TACCHR
TEXTPRO.json	TEXTPRO
THEJET1.json	THEJET1
THICK.json	THICK
THIN.json	THIN
THIN2.json	THIN2
THIN64.json	THIN64
THINCS.json	THINCS
TIEF.json	TIEF
TIM.json	TIM
TIMS.json	TIMS
TMCPROG.json	TMCPROG
TPBIG.json	TPBIG
TPC.json	TPC
TPC2.json	TPC2
TPFNC.json	TPFNC
UBEK.json	UBEK
ULTIMON.json	ULTIMON
UNDRLINE.json	UNDRLINE
WARHAWK.json	WARHAWK
WHIREWIL.json	WHIREWIL
WIDE.json	WIDE
WRITTEN.json	WRITTEN
YAHTZEE.json	YAHTZEE
ZEBRA.json	ZEBRA
ZEICHEN.json	ZEICHEN
